S -> HashTag StrAll | Comment EndLine | Comment NS | Comment Comment | Comment Assign | Comment Assign | Comment Fungsi | InitVar Var2 | A | B | C | D | E | F | G | H | I | J | K | L | M | N | O | P | Q | R | S | T | U | V | W | X | Y | Z | a | b | c | d | e | f | g | h | i | j | k | l | m | n | o | p | q | r | s | t | u | v | w | x | y | z | _ | Object1 Object2 | Angka OAngka | Var OAngka | 0 | 1 | 2 | 3 | 4 | 5 | 6 | 7 | 8 | 9 | Angka Digit | Angka EndLine | Angka NS | Angka Comment | Angka Assign | Angka Fungsi | Assign EndLine | Assign NS | Assign Assign | Assign Var | Assign Angka | Assign Comment | Assign Fungsi | Fungsi NS | Fungsi Fungsi | Fungsi Assign | Fungsi Comment | Def Fungsi2 | KutipSatu Str1 | ChrIf BKondisi

NS -> EndLine S
Space -> Space Space | ~ 
EndLine -> Space EndLine | ;
Tab -> $


For     -> ChrFor BKondisi
ChrFor  -> Chrf ChrOr
ChrOr   -> Chro Chrr


While -> CharWhile BKondisi 
ChrWhile -> Chrw ChrHile 
ChrHile  -> Chrh ChrIle
ChrIle   -> Chri ChrLe
ChrLe    -> Chrl Chre


If -> ChrIf BKondisi
ChrIf -> Chri Chrf

Elif -> ChrElif BKondisi
ChrElif -> Chre ChrLif
ChrLif -> Chrl ChrIf 


BKondisi -> BKondisi Space | Space BKondisi | BKurung BooleanTKur
TKondisi -> TKondisi Space | Space TKondisi | TKurung TDNL
BooleanTKur -> BooleanTKur Space | Space BooleanTKur | Boolean TKondisi

TDNL -> TD EndLine

Boolean -> VarTrue AndOrBoolean | VarFalse AndOrBoolean | Kondisi AndOrBoolean | ChrT ChrRue | ChrF Chralse | Kondisi Space | Space Kondisi | Var Kondisi2

AndOrBoolean -> VarAnd Boolean | VarOr Boolean

Kondisi -> Kondisi Space | Space Kondisi | Vars Kondisi2
Kondisi2 -> Kondisi2 Space | Space Kondisi2 | Kondisi2 StrAll | SamaDeg2 Object2 | SeruSamaDeg Object2 | KurangDari Object2 | KurangDariSamaDeg Object2 | LebihDari Object2 | LebihDariSamaDeg Object2

SamaDeg2 -> SamaDeg SamaDeg
SeruSamaDeg -> Seru SamaDeg
KurangDariSamaDeg -> KurangDari SamaDeg
LebihDariSamaDeg -> LebihDari SamaDeg

is -> SamaDeg SamaDeg
VarAnd -> Chra ChrNd
ChrNd  ->  Chrn Chrd

VarOr  -> Chro Chrr

VarTrue -> ChrT ChrRue 
ChrRue  -> Chrr ChrUe 
ChrUe   -> Chru Chre

VarFalse -> ChrF ChrAlse
ChrAlse -> Chra ChRlse
ChrLse -> Chrl ChrSe
ChrSe -> Chrs Chre



Fungsi -> Def Fungsi2
Def -> BB Space
BB -> Chrd BB2
BB2 -> Chre Chrf
Fungsi2 -> Var Fungsi3
Fungsi3 -> ParamFungsi Fungsi4
Fungsi4 -> TD Fungsi5
Fungsi5 -> EndLine Inside
Inside -> Tab Inside2 | Tab Return
Inside2 -> HashTag StrAll | Comment EndLine | Comment NInside | Comment Comment | Comment Assign | Comment Assign | InitVar Var2 | A | B | C | D | E | F | G | H | I | J | K | L | M | N | O | P | Q | R | S | T | U | V | W | X | Y | Z | a | b | c | d | e | f | g | h | i | j | k | l | m | n | o | p | q | r | s | t | u | v | w | x | y | z | _ | Object1 Object2 | Var EndLine | 0 | 1 | 2 | 3 | 4 | 5 | 6 | 7 | 8 | 9 | Angka Digit | Angka EndLine | Angka NS | Angka Comment | Angka Assign | Assign EndLine | Assign NInside | Assign Assign | Assign Var | Assign Angka | Assign Comment
NInside -> EndLine Inside
Return -> Chrreturn Object2
Chrreturn -> Chrr Chrreturn2
Chrreturn2 -> Chre Chrreturn3
Chrreturn3 -> Chrt Chrreturn4
Chrreturn4 -> Chru Chrreturn5
Chrreturn5 -> Chrr Chrreturn6
Chrreturn6 -> Chrn Space
ParamFungsi -> BKurung ParamFungsi2
ParamFungsi2 -> Vars1 TKurung | )
Vars -> Space Vars | Vars Space | InitVar Var2 | A | B | C | D | E | F | G | H | I | J | K | L | M | N | O | P | Q | R | S | T | U | V | W | X | Y | Z | a | b | c | d | e | f | g | h | i | j | k | l | m | n | o | p | q | r | s | t | u | v | w | x | y | z | _
Vars1 -> Vars1 Vars2 | Space Vars | Vars Space | InitVar Var2 | A | B | C | D | E | F | G | H | I | J | K | L | M | N | O | P | Q | R | S | T | U | V | W | X | Y | Z | a | b | c | d | e | f | g | h | i | j | k | l | m | n | o | p | q | r | s | t | u | v | w | x | y | z | _
Vars2 -> Koma2 Vars1
Koma2 -> Space Koma | ,
Comment -> HashTag StrAll

Assign -> Object1 Object2
Object1 -> Var Eq
Object2 -> InitVar Var2 | A | B | C | D | E | F | G | H | I | J | K | L | M | N | O | P | Q | R | S | T | U | V | W | X | Y | Z | a | b | c | d | e | f | g | h | i | j | k | l | m | n | o | p | q | r | s | t | u | v | w | x | y | z | _ | KutipSatu Str1 | Angka Digit | 0 | 1 | 2 | 3 | 4 | 5 | 6 | 7 | 8 | 9 | Angka OAngka | Var OAngka | Object3 EndLine
OAngka -> OpMath Angka | OpMath Var
Eq -> Eq Space | Space Eq | = | GMiring SamaDeg | DGMiring SamaDeg | Plus SamaDeg | Minus SamaDeg | Bintang SamaDeg
EqMath -> = | GMiring SamaDeg | DGMiring SamaDeg | Plus SamaDeg | Minus SamaDeg | Bintang SamaDeg
EqStr -> = | GMiring SamaDeg | DGMiring SamaDeg | Plus SamaDeg | Minus SamaDeg | Bintang SamaDeg
OpMath -> Space OpMath | OpMath Space | + | - | / | GMiring GMiring | *
DGMiring -> GMiring GMiring

Angka -> Angka Digit | 0 | 1 | 2 | 3 | 4 | 5 | 6 | 7 | 8 | 9
Digit -> 0 | 1 | 2 | 3 | 4 | 5 | 6 | 7 | 8 | 9

Var -> InitVar Var2 | A | B | C | D | E | F | G | H | I | J | K | L | M | N | O | P | Q | R | S | T | U | V | W | X | Y | Z | a | b | c | d | e | f | g | h | i | j | k | l | m | n | o | p | q | r | s | t | u | v | w | x | y | z | _
Var2 -> Var2 ChrVar | ChrVar ChrVar | A | B | C | D | E | F | G | H | I | J | K | L | M | N | O | P | Q | R | S | T | U | V | W | X | Y | Z | a | b | c | d | e | f | g | h | i | j | k | l | m | n | o | p | q | r | s | t | u | v | w | x | y | z | 0 | 1 | 2 | 3 | 4 | 5 | 6 | 7 | 8 | 9 | _
InitVar -> A | B | C | D | E | F | G | H | I | J | K | L | M | N | O | P | Q | R | S | T | U | V | W | X | Y | Z | a | b | c | d | e | f | g | h | i | j | k | l | m | n | o | p | q | r | s | t | u | v | w | x | y | z | _
ChrVar -> A | B | C | D | E | F | G | H | I | J | K | L | M | N | O | P | Q | R | S | T | U | V | W | X | Y | Z | a | b | c | d | e | f | g | h | i | j | k | l | m | n | o | p | q | r | s | t | u | v | w | x | y | z | 0 | 1 | 2 | 3 | 4 | 5 | 6 | 7 | 8 | 9 | _

Str -> KutipSatu Str1
Str1 -> Str0 KutipSatu
Str0 -> Str0 Chr | Chr Chr
Chr -> 0 | 1 | 2 | 3 | 4 | 5 | 6 | 7 | 8 | 9 | a | b | c | d | e | f | g | h | i | j | k | l | m | n | o | p | q | r | s | t | u | v | w | x | y | z | A | B | C | D | E | F | G | H | I | J | K | L | M | N | O | P | Q | R | S | T | U | V | W | X | Y | Z | ! | # | $ | % | & | ( | ) | * | + | , | - | . | / | : | ; | < | = | > | ? | @ | [ | \ | ] | ^ | _ | ` | { | | | } | ~ | "

StrAll -> StrAll ChrAll | ChrAll ChrAll
ChrAll -> 0 | 1 | 2 | 3 | 4 | 5 | 6 | 7 | 8 | 9 | a | b | c | d | e | f | g | h | i | j | k | l | m | n | o | p | q | r | s | t | u | v | w | x | y | z | A | B | C | D | E | F | G | H | I | J | K | L | M | N | O | P | Q | R | S | T | U | V | W | X | Y | Z | ! | " | # | $ | % | & | ' | ( | ) | * | + | , | - | . | / | : | ; | < | = | > | ? | @ | [ | \ | ] | ^ | _ | ` | { | | | } | ~

KutipSatu -> '
HashTag -> #
Chr_ -> _
TD -> :
BKurung -> ( | BKurung Space
TKurung -> ) | Space TKurung | TKurung Space
Koma -> ,
SamaDeg -> =
GMiring -> /
Plus -> +
Minus -> -
Bintang -> *
Seru -> !
KurangDari -> <
LebihDari -> >

ChrA -> A
ChrB -> B
ChrC -> C
ChrD -> D
ChrE -> E
ChrF -> F
ChrG -> G
ChrH -> H
ChrI -> I
ChrJ -> J
ChrK -> K
ChrL -> L
ChrM -> M
ChrN -> N
ChrO -> O
ChrP -> P
ChrQ -> Q
ChrR -> R
ChrS -> S
ChrT -> T
ChrU -> U
ChrV -> V
ChrW -> W
ChrX -> X
ChrY -> Y
ChrZ -> Z
Chra -> a
Chrb -> b
Chrc -> c
Chrd -> d
Chre -> e
Chrf -> f
Chrg -> g
Chrh -> h
Chri -> i
Chrj -> j
Chrk -> k
Chrl -> l
Chrm -> m
Chrn -> n
Chro -> o
Chrp -> p
Chrq -> q
Chrr -> r
Chrs -> s
Chrt -> t
Chru -> u
Chrv -> v
Chrw -> w
Chrx -> x
Chry -> y
Chrz -> z
Chr0 -> 0
Chr1 -> 1
Chr2 -> 2
Chr3 -> 3
Chr4 -> 4
Chr5 -> 5
Chr6 -> 6
Chr7 -> 7
Chr8 -> 8
Chr9 -> 9
Chr_ -> _